1111111111111111111111111111
10000000000000000000C0000001
1P00EC10000000000C001000C001
1000000001C000C0000000000001
1C001001000001000C0000000001
1111111111111111111111111111