111111111111111111111111
1C0001C1010000C001010101
111001011000001001011001
1C000CCCC0000C000CCCC001
100101001111001111C00001
111000010000011110001111
101000011000001001P11001
1C000C0CC0000C000C0CC001
101001010000001001010001
1C000CC000000C000CC00001
101001001000001001001001
100E000000010CCCCCCCCCC1
111111111111111111111111